20
10
BBBBBBBBBBBBBBBBBBBB
B                  B
B  TTT   CCC    >  B
B                  B
B               v  B
B  R     AAA       B
B               <  B
B  LLL   WWW  ^    B
B                  B
BBBBBBBBBBBBBBBBBBBB
