20
10
BBBBBBBBBBBBBBBBBBBB
B                  B
B  TTT   CCC    >  B
B        F         B
B               v  B
B  R     AAA       G
B               <  B
B  LLL   WWW  ^    B
B                  B
BBBBBBBBBBBBBBBBBBBB
