22
10
BBBBBBBBBBBBBBBBBBBBBB
BCCCCCCCCB  BTTTTTTTTB
BCCCCCCCCB  BTTTTTTTTB
B  BBBBBBB  BBBBBBB  B
B                    B
B                    B
B  BBBBBBB  BBBBBBB  B
BTTTTTTTTB  BLLLLLLLLB
BTTTTTTTTB RBLLLLLLLLB
BBBBBBBBBBBGBBBBBBBBBB
