20
12
BBBBBBBBBBGBBBBBBBBB
B                  B
B CCCCCCCCCCCCCCCC B
B C              C B
BRC              C B
B C              C B
B C A          A C B
B C BBBBBTBBBBBB C B
B C BTTTT TTTTTB C B
B C BTTTT TTTTTB C B
B   BTTTT TTTTTB   B
BBBBBBBBBBBBBBBBBBBB
