26
11
BBBBBBBBBBBBBBBBBBBBBBBBBB
BCCCC>        >          B
BCCCC>        > A      A B
BCCCC>  TTTTT > ACCCC  A B
BCCCC>  LLLLL > A   C  A B
BCCCC>      C > A F    A B
BCCCC>        > AAAAAAAA G
BBB^^^^^^^^^^^^^^^^^^^^^^B
BWTWLLWTWTWWLWTWLWTWLWTWRB
BTWTWLLTWTWTWTWLWWTWLTWTWB
BBBBBBBBBBBBBBBBBBBBBBBBBB
